00000100000000100000
00111100100111100100
00100100000100000000
00000111110100111100
00000100000100000100
00111100100111110100
00000100000000100100
00111100111010100100
00100000001010000100
00101111101011111100
00101000001000000000
00101010111011111100
00000010000010000000
00111110111110100100
00000000100000100100
00111110101111100100
00100000100000000100
00101111100100111100
00100000111100000100
00000100000000100000