00000000000000000000
00000000000000000000
00011100000000000000
00000000111000000000
00000000000000000000
00000001110000000000
00000000000000000000
00000000011100000000
00000000000000000000
00001110000000000000
00000000000011100000
00001110000000000000
00000000011100000000
00000000000000111000
00000111000000000000
00011100000000000000
00000000001110000000
00000111000000000000
00000000000000000000
00000000000000000000