00000000000000000000
00111000000000000000
00000000000000000000
00000000000000000000
00000001110000000000
00000000000000000000
00000000000000000000
00000000011100000000
00000000000000000000
00000000000000000000
00000000000011100000
00000000000000000000
00000000000000000000
00000000000000111000
00000000000000000000
00000000000000000000
00000000001110000000
00000000000000000000
00000000000000000000
00000111000000000000