11111111111111111111
10000000000000000001
10001110000000000001
10001110000111110001
10000000000000110001
10000110000000110001
10000000000000100001
10000100000000000001
10000111000000000001
10001100000000110001
10000100000000010001
10000000000000000001
10001000000000001101
10001110000000001101
10000000000000000001
10000000000000000001
10001111100000010001
10000001110000111001
10000000000000000001
11111111111111111111