Maze

00000000000000000000
00000000000000000000
00011100000000000000
00000000111000000000
00000000000000000000
00000001110000000000
00000000000000000000
00000000011100000000
00000000000000000000
00001110000000000000
00000000000011100000
00001110000000000000
00000000011100000000
00000000000000111000
00000111000000000000
00011100000000000000
00000000001110000000
00000111000000000000
00000000000000000000
00000000000000000000

00000000000011100000
00000000011100000000
00000000000000000000
00000000000000000000
00000000000000000000
00000000000000000000
00000011100001110000
00000000000000000000
00000000000000000000
01110000000000000111
00001110000011100000
00000000000000000000
00000000000000000000
00000000000000001110
00000000000001110000
00000000000000000000
00000000000000000000
00000000111000000000
00111000000011100000
00000000000000000000

00000011100111000000
00000000000000000000
00000011100000000000
00000000000000000000
00000000011101110000
00000000000000000000
00000000000000000000
00000011100000000000
00000111011100000000
00000000000000000000
00000000000011100000
00000000000000000000
00000000000000000000
00000000000000011100
00000001110000000000
00000000000000000000
00000000000000000000
00000000000000000000
00000011100000000000
00000000000111000000

00000000000000000000
00000000000000000000
00000000000000000000
00000000000000000000
00000000000111000000
00001110111000000000
00000000000000000000
00000000000000000000
00000000000011100000
00000000000111000000
00011100000000001110
00000001110000000000
00000000000000000111
00000000000000000000
00000000111000000000
00000000000000000000
00000000000000000000
00000000000000011100
00000000000000000000
00000000111000111000

00000000000000000000
00000000000000000000
00000000000000000000
00000000000011100000
00011100000000000000
00000000000000000000
11100000000000111000
00000000000000000000
00000000000000111000
11100000001110000000
00000000000000000000
11100000000000000000
00000000000000000000
00000111000000000000
00000000001110000000
00000000000000000000
00000000000000000000
00000000000000000000
00000000000000000111
00000000011100011100

00000001110000000000
00000000000000000000
00111000000000000000
00000000000000000000
00000000000000000000
00000000000000000000
00000000000000000000
00000001110000000000
00000000000000111000
00000000000011100111
11100000000000000000
00011100000000000000
00000000000000111000
00000000000000000000
00000000000000000000
00000000000011100000
00111000000000000000
00000000000000011100
00000000000000000000
00000000000011100000

